###############
#             S
##### #########
###   #########
#####E#########